XXXXXXX
S.XXXXX
X..XXXX
XX.XXXX
XX.XXXX
XX....X
XXXXXEX
