XXXXXXX
S.XXXXX
X.XXXXX
X.XXXXX
X....XX
X.XX..X
XXXXXEX